13
0 0 0 0 0 0 0 0 0 0 0 0 0
0 0 0 S 0 B 0 T 0 0 0 0 0
0 0 T T 0 S 0 B B 0 0 0 0
S 0 T 0 T S B 0 0 S 0 S S
0 0 0 0 0 0 W W 0 0 0 0 0
T S 0 0 0 0 0 S S W W 0 S
0 0 0 T S 0 0 0 T 0 0 W W
0 T 0 0 W T B 0 T S 0 0 0
0 0 0 0 0 T 0 S W W 0 W 0
B S 0 S 0 B 0 0 0 S 0 T T
0 0 0 0 0 0 0 B P 0 W 0 S
T 0 T 0 0 B B B B 0 0 0 W
0 0 0 0 0 B 0 B 0 0 0 0 0

7
B B S 0 0 0 0
0 0 W S 0 B 0 
P 0 T T 0 S 0 
S 0 T 0 T S 0
0 0 0 0 0 0 T
T S 0 0 0 0 0
0 T 0 T S 0 T

